//MAP CONVERTED BY dmm2tgm.py THIS HEADER COMMENT PREVENTS RECONVERSION, DO NOT REMOVE
"cE" = (
/obj/structure/machinery/light{
	dir = 8
	},
/turf/open/floor/kutjevo/multi_tiles,
/area/shuttle/ert)
"dN" = (
/obj/item/device/flashlight/lamp/green{
	on = 1
	},
/obj/structure/surface/table/woodentable/fancy,
/turf/open/floor/kutjevo/colors/red{
	icon_state = "red3"
	},
/area/shuttle/ert)
"ed" = (
/obj/structure/bed/chair/vehicle{
	dir = 1;
	pixel_x = 8
	},
/obj/structure/bed/chair/vehicle{
	dir = 1;
	pixel_x = -8
	},
/turf/open/floor/kutjevo/colors/red/tile,
/area/shuttle/ert)
"eD" = (
/obj/structure/window/framed/kutjevo/reinforced,
/turf/open/floor/kutjevo/colors,
/area/shuttle/ert)
"fq" = (
/obj/structure/machinery/door/airlock/external/colony{
	req_one_access = null
	},
/turf/open/floor/kutjevo/colors,
/area/shuttle/ert)
"hx" = (
/obj/structure/surface/table/woodentable/fancy,
/obj/structure/machinery/computer/shuttle/ert/big{
	dir = 8
	},
/turf/open/floor/kutjevo/colors/red{
	icon_state = "red2"
	},
/area/shuttle/ert)
"jC" = (
/turf/open/floor/kutjevo/plate,
/area/shuttle/ert)
"kS" = (
/turf/open/floor/kutjevo/colors/red/edge,
/area/shuttle/ert)
"lj" = (
/obj/structure/bed/chair/comfy{
	dir = 4;
	pixel_y = 6
	},
/turf/open/floor/kutjevo/colors/red{
	icon_state = "red2"
	},
/area/shuttle/ert)
"ma" = (
/obj/item/device/flashlight/lamp/green{
	on = 1
	},
/obj/structure/surface/table/woodentable/fancy,
/turf/open/floor/kutjevo/colors/red{
	icon_state = "red3";
	dir = 1
	},
/area/shuttle/ert)
"mm" = (
/obj/structure/surface/table/woodentable/fancy,
/turf/open/floor/kutjevo/colors/red{
	icon_state = "red4";
	dir = 1
	},
/area/shuttle/ert)
"oF" = (
/obj/docking_port/mobile/emergency_response/big{
	dir = 4;
	preferred_direction = 8;
	height = 17;
	width = 5;
	dwidth = 2
	},
/turf/closed/wall/kutjevo/colony/reinforced{
	icon_state = "colonyh"
	},
/area/shuttle/ert)
"qH" = (
/turf/open/floor/kutjevo/colors,
/area/shuttle/ert)
"vl" = (
/turf/open/floor/kutjevo/multi_tiles,
/area/shuttle/ert)
"vJ" = (
/turf/open/floor/kutjevo/colors/red{
	icon_state = "red2"
	},
/area/shuttle/ert)
"wi" = (
/obj/structure/machinery/door/airlock/almayer/secure/autoname,
/turf/open/floor/kutjevo/colors/red/tile,
/area/shuttle/ert)
"wN" = (
/obj/structure/surface/table/woodentable/fancy,
/turf/open/floor/kutjevo/colors/red{
	icon_state = "red4";
	dir = 8
	},
/area/shuttle/ert)
"xx" = (
/turf/closed/wall/kutjevo/colony/reinforced{
	icon_state = "colonyh"
	},
/area/shuttle/ert)
"yB" = (
/turf/closed/wall/kutjevo/colony/reinforced/hull,
/area/shuttle/ert)
"zZ" = (
/obj/item/storage/fancy/cigar,
/obj/item/device/flashlight/lamp/green{
	on = 1
	},
/obj/structure/surface/table/woodentable/fancy,
/turf/open/floor/kutjevo/colors/red/tile,
/area/shuttle/ert)
"Cf" = (
/obj/item/device/flashlight/lamp/green{
	on = 1
	},
/obj/item/tool/lighter/zippo/gold,
/obj/structure/surface/table/woodentable/fancy,
/turf/open/floor/kutjevo/colors/red/tile,
/area/shuttle/ert)
"Ey" = (
/obj/structure/bed/chair/vehicle{
	pixel_x = -8;
	pixel_y = 16
	},
/obj/structure/bed/chair/vehicle{
	pixel_x = 8;
	pixel_y = 16
	},
/turf/open/floor/kutjevo/colors/red/tile,
/area/shuttle/ert)
"EG" = (
/obj/structure/window/framed/kutjevo/reinforced,
/turf/open/floor/kutjevo/multi_tiles,
/area/shuttle/ert)
"Ly" = (
/turf/open/floor/kutjevo/colors/red/tile,
/area/shuttle/ert)

(1,1,1) = {"
xx
xx
oF
xx
xx
"}
(2,1,1) = {"
fq
kS
cE
ed
eD
"}
(3,1,1) = {"
eD
Ly
qH
ed
eD
"}
(4,1,1) = {"
fq
kS
vl
ed
eD
"}
(5,1,1) = {"
xx
zZ
jC
Cf
xx
"}
(6,1,1) = {"
eD
Ey
vl
ed
eD
"}
(7,1,1) = {"
eD
Ey
qH
ed
eD
"}
(8,1,1) = {"
eD
Ey
vl
ed
eD
"}
(9,1,1) = {"
xx
zZ
jC
Cf
xx
"}
(10,1,1) = {"
fq
kS
vl
ed
eD
"}
(11,1,1) = {"
eD
Ly
qH
ed
eD
"}
(12,1,1) = {"
fq
kS
vl
ed
eD
"}
(13,1,1) = {"
xx
xx
wi
xx
xx
"}
(14,1,1) = {"
EG
vJ
vl
vJ
EG
"}
(15,1,1) = {"
EG
dN
lj
ma
EG
"}
(16,1,1) = {"
EG
mm
hx
wN
EG
"}
(17,1,1) = {"
yB
EG
EG
EG
yB
"}
