//MAP CONVERTED BY dmm2tgm.py THIS HEADER COMMENT PREVENTS RECONVERSION, DO NOT REMOVE
"cE" = (
/turf/open/floor/kutjevo/colors/red/edge{
	dir = 1
	},
/area/shuttle/amongus)
"dN" = (
/obj/item/device/flashlight/lamp/green{
	on = 1
	},
/obj/structure/surface/table/woodentable/fancy,
/turf/open/floor/kutjevo/colors/red{
	icon_state = "red3"
	},
/area/shuttle/amongus)
"ed" = (
/obj/structure/bed/chair/comfy{
	dir = 1;
	pixel_x = 8;
	pixel_y = 4
	},
/obj/structure/bed/chair/comfy{
	dir = 1;
	pixel_x = -8;
	pixel_y = 4
	},
/turf/open/floor/kutjevo/colors/red/edge{
	dir = 1
	},
/area/shuttle/amongus)
"eD" = (
/obj/structure/window/framed/kutjevo/reinforced,
/turf/open/floor/kutjevo/colors,
/area/shuttle/amongus)
"fq" = (
/obj/structure/machinery/door/airlock/external/colony,
/turf/open/floor/kutjevo/colors,
/area/shuttle/amongus)
"hx" = (
/obj/structure/surface/table/woodentable/fancy,
/obj/structure/machinery/computer/shuttle/dropship/flight/small{
	dir = 8
	},
/turf/open/floor/kutjevo/colors/red{
	icon_state = "red2"
	},
/area/shuttle/amongus)
"jC" = (
/turf/open/floor/kutjevo/plate,
/area/shuttle/amongus)
"kS" = (
/obj/structure/bed/chair/comfy{
	pixel_y = 8;
	pixel_x = -8
	},
/obj/structure/bed/chair/comfy{
	pixel_y = 8;
	pixel_x = 8
	},
/turf/open/floor/kutjevo/colors/red/edge,
/area/shuttle/amongus)
"lj" = (
/obj/structure/bed/chair/comfy{
	dir = 4;
	pixel_y = 6
	},
/turf/open/floor/kutjevo/colors/red{
	icon_state = "red2"
	},
/area/shuttle/amongus)
"ma" = (
/obj/item/device/flashlight/lamp/green{
	on = 1
	},
/obj/structure/surface/table/woodentable/fancy,
/turf/open/floor/kutjevo/colors/red{
	icon_state = "red3";
	dir = 1
	},
/area/shuttle/amongus)
"mm" = (
/obj/structure/surface/table/woodentable/fancy,
/turf/open/floor/kutjevo/colors/red{
	icon_state = "red4";
	dir = 1
	},
/area/shuttle/amongus)
"oF" = (
/obj/structure/bed/chair/comfy{
	dir = 1;
	pixel_x = 8;
	pixel_y = 4
	},
/obj/structure/bed/chair/comfy{
	dir = 1;
	pixel_x = -8;
	pixel_y = 4
	},
/turf/open/floor/kutjevo/colors/red/tile,
/area/shuttle/amongus)
"qH" = (
/turf/open/floor/kutjevo/colors,
/area/shuttle/amongus)
"vl" = (
/turf/open/floor/kutjevo/multi_tiles,
/area/shuttle/amongus)
"vJ" = (
/turf/open/floor/kutjevo/colors/red{
	icon_state = "red2"
	},
/area/shuttle/amongus)
"wi" = (
/obj/structure/machinery/door/airlock/almayer/secure/autoname,
/turf/open/floor/kutjevo/colors/red/tile,
/area/shuttle/amongus)
"wN" = (
/obj/structure/surface/table/woodentable/fancy,
/turf/open/floor/kutjevo/colors/red{
	icon_state = "red4";
	dir = 8
	},
/area/shuttle/amongus)
"xx" = (
/turf/closed/wall/kutjevo/colony/reinforced{
	icon_state = "colonyh"
	},
/area/shuttle/amongus)
"yB" = (
/turf/closed/wall/kutjevo/colony/reinforced/hull,
/area/shuttle/amongus)
"zZ" = (
/obj/item/storage/fancy/cigar,
/obj/item/device/flashlight/lamp/green{
	on = 1
	},
/obj/structure/surface/table/woodentable/fancy,
/turf/open/floor/kutjevo/colors/red/tile,
/area/shuttle/amongus)
"Cb" = (
/turf/open/floor/kutjevo/colors/red/tile,
/area/shuttle/amongus)
"Cf" = (
/obj/item/device/flashlight/lamp/green{
	on = 1
	},
/obj/item/tool/lighter/zippo/gold,
/obj/structure/surface/table/woodentable/fancy,
/turf/open/floor/kutjevo/colors/red/tile,
/area/shuttle/amongus)
"Ey" = (
/obj/docking_port/mobile/marine_dropship/amongus,
/turf/open/floor/kutjevo/colors,
/area/shuttle/amongus)
"EG" = (
/obj/structure/window/framed/kutjevo/reinforced,
/turf/open/floor/kutjevo/multi_tiles,
/area/shuttle/amongus)
"Ly" = (
/obj/structure/bed/chair/comfy{
	pixel_y = 8;
	pixel_x = -8
	},
/obj/structure/bed/chair/comfy{
	pixel_y = 8;
	pixel_x = 8
	},
/turf/open/floor/kutjevo/colors/red/tile,
/area/shuttle/amongus)

(1,1,1) = {"
xx
xx
xx
xx
xx
"}
(2,1,1) = {"
eD
kS
vl
ed
eD
"}
(3,1,1) = {"
eD
Ly
qH
oF
eD
"}
(4,1,1) = {"
eD
kS
vl
ed
eD
"}
(5,1,1) = {"
xx
zZ
jC
Cf
xx
"}
(6,1,1) = {"
eD
kS
vl
cE
fq
"}
(7,1,1) = {"
eD
Ly
Ey
Cb
eD
"}
(8,1,1) = {"
eD
kS
vl
cE
fq
"}
(9,1,1) = {"
xx
zZ
jC
Cf
xx
"}
(10,1,1) = {"
eD
kS
vl
ed
eD
"}
(11,1,1) = {"
eD
Ly
qH
oF
eD
"}
(12,1,1) = {"
eD
kS
vl
ed
eD
"}
(13,1,1) = {"
xx
xx
wi
xx
xx
"}
(14,1,1) = {"
EG
vJ
vl
vJ
EG
"}
(15,1,1) = {"
EG
dN
lj
ma
EG
"}
(16,1,1) = {"
EG
mm
hx
wN
EG
"}
(17,1,1) = {"
yB
EG
EG
EG
yB
"}
